position, team, games_played, won, draw, lost, goals_scored, goals_conceded, goal_difference, points
1,Atletico Madrid,38,26,8,4,67,25,42,86
2,Real Madrid,38,25,9,4,67,28,39,84
3,Barcelona,38,24,7,7,85,38,47,79
4,Sevilla,38,24,5,9,53,33,20,77
5,Real Sociedad,38,17,11,10,59,38,21,62
6,Real Betis,38,17,10,11,50,50,0,61
7,Villarreal,38,15,13,10,60,44,16,58
8,Celta Vigo,38,14,11,13,55,57,-2,53
9,Granada,38,13,7,18,47,65,-18,46
10,Athletic Club,38,11,13,14,46,42,4,46
11,Osasuna,38,11,11,16,37,48,-11,44
12,Cadiz,38,11,11,16,36,58,-22,44
13,Valencia,38,10,13,15,50,53,-3,43
14,Levante,38,9,14,15,46,57,-11,41
15,Getafe,38,9,11,18,28,43,-15,38
16,Deportivo Alaves,38,9,11,18,36,57,-21,38
17,Elche,38,8,12,18,34,55,-21,36
18,SD Huesca,38,7,13,18,34,53,-19,34
19,Real Valladolid,38,5,16,17,34,57,-23,31
20,Eibar,38,6,12,20,29,52,-23,30
